11111111
10000001
1000N001
11110111
10000001
10001101
10001001
11111111
