1111111111
1001010001
1001N11101
1000000001
1111111111
