11111111
10010101
1001N101
10000001
10100001
10100001
10100001
11111111
