1111111111111111111111111111111
1001010001000000000000010000011
1001N11101100000000000000000011
1000000001000000000000000000001
1011000000000000000000000000001
1011010000010000100000000000001
1011010000001000111111111000001
1111010000000100011000000000001
1000010000000100011000000000001
1111111111111111111111111111111
