22222222222222222222222222
20000000000000000000000002
22022222222222222222222202
20000000000000000000000202
20000000000030000000000202
20000000000030000000000202
20000000000033333333333302
20000000000000000000000002
2500N002000032222222222222
20000002333030000000000003
20000002333030000000000003
20000002333030000000000003
20000002333030000000000003
20000002333030000000000003
20000002333030000000000003
20000002333030000000000003
20000002333030000000000003
20000002333030000000000003
20000002333030000000000003
20000002333030000000000003
20000000000000000000000003
25000002222222222222220003
20002202200022022000220201
25002000000000000000000002
22222111222222222222222222
