R 1920 1010
NO ./pics/eagle.xpm
SO ./pics/wall_1.xpm
WE ./pics/bluestone.xpm
EA ./pics/wall_2.xpm
S  ./pics/pillar.xpm
F 255,100,0
C 128,85,0

    1111111111111111111111
    1101100377777777777771
    1000000000070000700771
    1100001700077700700711
    1110001700000000000711
    1110111177777700777711
    1100001111111500511111
    1100005055555000055511
    1110005000000000000511
    1111005002000001111111
 111115500000000000511
 100000050030W01000511
 100000005000000005511
 100000000500700050011
 100000000050000500011
 100000000005005000011
 100000000000000000011
 100000000000000000011
 100000000000000000011 
 100000000000000000011 
 11111111111111111111 
                                

