R 1024 780 

NO ./pics/eagle.xpm

SO ./pics/wall_1.xpm

WE ./pics/bluestone.xpm

EA ./pics/wall_2.xpm

S  ./pics/pillar.xpm

F 180,      255,   255
C 88,58,20

   1111111111111111111111
   1200000000000000000001
   1000000000000000000001
   1000000000000000000001
   1000000000000000000001
   1000000000000000000001
   1200000000000000000021
   11110000000000S1111111
111111100000000000111
120000210000000000111
100000021000000001211
100000002100000012011
100000000210000120011
100000000021001200011
100000000000000000011
100000000000000000011
100000000000000000011
120000000000000000211
1111111111111111111111
