111111
100101
100N01
110001
111111
